///////////////////////////////////////////////////////////////////////////////////
/...!/////////////////////////////.....////////////////////////////////////////////
/...........//////////////////////..%..////////////////////////////////////////////
/....//////.//////////////////////.....////////////////////////////////////////////
///////////.//////////////////////.////////////////////////////////////////////////
///////////.//////////////////////.////////////////////////////////////////////////
//////////...................................................._..........//////////
//////////.............._........................._..........|=|.........//////////
//////////.............|=|.......................|=|.....................//////////
//////////............................_..................................//////////
//////////...........................|=|.........///////////////////////.//////////
//////////.........._............................////////._|_.//////////.//////////
//////////.........|=|...........................////////..|..//////////.//////////
//////////.......................................//////..._|_.....//////.//////////
//////////.............................._........//////..//_/\....//////.//////////
//////////..............._.............|=|.......///...__|__||____....//.//////////
//////////........_.....|=|......................///..////////////\...//.//////////
//////////.......|=|............._...............///./////////////\\..//.//////////
//////////......................|=|..............///.|^^^^^^^^^^||+|..$..//////////
////////////////////////////////////////////////////.|...#.#.#..||||!./////////////

