////////////............//////////////////////////............//////........./////.
/...////////.//////////./////////..................///.////////......///////.......
/...................///./////////.//./////////////////..........////////////////./.
/$////.////////////////...........//......../////////////////////.............//./.
/...//.////////////////.//////////////////////............///////.//.////////.//./.
/..!//..............///.///.///................////./////.///////.//.//....//.//./.
//////.///////.////////.///.///.//.////.///////////./////.....///.//.//.//.//.//./.
//////.///////.///......///.///.//.////.........///./////////.....//....//.//.//./.
//////.///.....////////.//..///.//..//____________/.//////////////////.///.//.//.//
/......////////////.....//.////..//.//|..........|/........//////......///.//.//.//
/.////.........////.//////....//.//...|..........|////.//////..///////////.//.//...
/./////////////////.//////.//.//.////.|..........|////.///////.............//.////.
/...../////....////.//////./////.////.|_________....//...////////////////////.///..
/////./////.//...//..............//.....//.////////.//.////...................///./
//.//./////.////.//////////////////.///.//.////.///.///////./////////////////////./
//../.......////........////////....///.//......///........././/..//////////....../
///.///./////////////////......////////.//.//////////////////....///////////.///.//
///.///........./////////.////.//////...//............///////.//.....///////.///.//
/.......///////.............//....////////.//////////.........///.//..../....///../
/////////////////////////////////..........//////////////////////./////////////////